111111111111111111
10CP00000000000001
1000EC0000000000M1
10000C0000000000C1
111111111111111111
