11111111
1C000001
10101101
1P1E1MC1
11111111