111111111
1C00M0001
10M0M0M01
1PM00CME1
111111111